
 #             ####
 #####         #  #
 #   ##############
 #   #       #
 ###$#####   #
 #  #        #
    ##########
  ####
  #  #       #
  #  #       #
  ############
       #
       #
       ####
          ##
                  
